A	AH
A(2)	EY
AMASE	AH M EY Z
AN	AE N
AN(2)	AH N
AND	AH N D
AND(2)	AE N D
AT	AE T
B	B IY
C	S IY
D	D IY
E	IY
EIGHT	EY T
EXECUTE	EH K S AH K Y UW T
F	EH F
FIVE	F AY V
FOUR	F AO R
G	JH IY
HERE	HH IY R
LET	L EH T
LOCATION	L OW K EY SH AH N
LOITER	L OY T ER
NINE	N AY N
ONE	W AH N
ONE(2)	HH W AH N
OTHER	AH DH ER
SEARCH	S ER CH
SEVEN	S EH V AH N
SIX	S IH K S
START	S T AA R T
THREE	TH R IY
TRACK	T R AE K
TWO	T UW
UAV	Y UW AH V
WORDS	W ER D Z